1234212124
1 2   0  3
0 1   1  2
3 2   2  1
3     3  1
2  3  4  3
1  2     1
4  1   1 2
3  4   2 0
3212312311